40
0 6 3 3 2 2 3 3 6 0
 1 1 0 4 4 4 0 1 1
4 4 4 6 2 2 6 4 4 4
 2 2 1 1 5 1 1 2 2
5 4 4 6 6 4 4 6 6 5
 5 3 1 1 0 1 1 3 5
6 3 2 2 6 6 2 2 3 6
 6 4 0 1 0 1 0 4 6
0 4 0 1 3 3 1 0 4 0
 0 6 6 5 0 5 6 6 0
0 0 0 0 2 2 0 0 0 0