20
0 5 5 2 2 2 2 5 5 0
 2 5 5 2 2 2 5 5 2
2 2 5 5 2 2 5 5 2 2
 4 1 5 5 2 5 5 1 4
4 4 1 3 3 3 3 1 4 4
 4 4 1 5 5 5 1 4 4
4 4 4 1 2 2 1 4 4 4
 4 4 1 5 5 5 1 4 4
1 4 1 3 3 3 3 1 4 0
 1 1 5 5 2 5 5 1 1
2 2 5 5 2 2 5 5 2 2
 2 5 5 2 2 2 5 5 2
0 5 5 2 2 2 2 5 5 0