25
0 0 1 0 0 0 0 1 0 0
 2 3 1 0 0 0 1 4 5
2 3 3 1 2 2 1 4 4 5
 4 5 5 5 2 5 5 5 3
4 1 1 4 2 2 3 6 6 3
 3 1 4 0 1 0 3 6 4
0 3 4 0 6 6 0 3 4 0
 0 5 0 0 1 0 0 1 0
0 0 1 1 4 4 6 6 0 0