20
0 0 0 3 2 2 3 0 0 0
 0 4 0 3 4 3 0 2 0
0 2 2 2 1 1 4 4 4 0
 4 0 0 0 5 0 0 0 2
0 0 0 0 3 3 0 0 0 0
 0 0 6 6 0 6 6 0 0
0 0 0 4 0 0 4 0 0 0
 0 1 1 0 0 0 1 1 0
0 3 2 2 0 0 2 2 6 0
 6 3 0 0 0 0 0 6 3
0 6 0 0 0 0 0 0 3 0