20
4 4 4 2 6 6 2 4 4 4
 3 3 0 0 2 0 0 3 3
1 1 0 6 1 1 6 0 1 1
 6 0 4 4 6 4 4 0 6
6 3 0 0 6 6 0 0 3 6
 3 0 0 1 0 1 0 0 3
0 0 0 1 0 0 1 0 0 0
 0 0 4 0 0 0 4 0 0
0 0 4 0 0 0 0 4 0 0
 0 0 5 0 0 0 5 0 0