40
1 6 6 6 2 2 3 3 3 1
 6 6 6 2 2 2 3 3 3
1 0 4 0 5 5 0 4 0 1
 0 2 0 0 3 0 0 2 0
0 0 3 0 2 2 0 3 0 0
 0 0 1 0 4 0 1 0 0
0 0 0 5 1 1 5 0 0 0
 5 4 4 6 0 6 4 4 5
5 2 0 0 3 3 0 0 2 5
 2 0 0 0 2 0 0 0 2
0 1 1 1 6 6 1 1 1 0
 0 0 4 0 0 0 4 0 0
0 0 0 4 5 5 4 0 0 0