20
2 2 4 3 1 1 1 4 4 4
 2 2 4 3 1 1 6 4 4
2 2 2 4 3 1 6 1 4 4
 2 2 2 2 2 6 1 1 4
1 1 1 4 5 3 1 1 6 4
 2 2 4 5 5 3 1 6 1
2 2 6 5 5 5 2 6 1 1
 2 4 6 5 5 4 3 1 1
2 4 5 6 5 4 4 3 1 1
 4 5 5 6 4 2 4 5 1
4 1 5 5 4 2 2 4 3 1
 5 1 5 4 2 2 2 4 3
5 5 1 4 2 2 2 2 4 3