15
2 2 2 2 2 6 6 6 6 6
 6 6 1 1 1 1 1 4 4
6 6 1 5 5 5 5 1 4 3
 5 6 5 6 6 6 5 1 3
1 5 6 2 2 2 6 5 1 3
 1 5 6 6 6 6 5 1 4
0 1 5 5 5 5 5 1 4 4
 2 1 1 1 1 1 1 2 2
2 2 6 6 3 3 4 4 2 0
 0 1 0 1 0 5 0 5 0