20
0 0 0 0 5 5 0 0 0 0
 0 0 0 6 5 1 0 0 0
0 0 0 4 6 1 2 0 0 0
 0 0 3 4 0 2 6 0 0
0 0 5 3 0 0 6 4 0 0
 0 2 5 0 0 0 4 1 0
0 1 2 0 0 0 0 1 5 0
 3 1 0 0 0 0 0 5 6
4 3 0 0 0 0 0 0 6 2
 4 5 5 5 1 3 3 3 2
0 6 0 2 0 0 4 0 5 0
 6 0 2 3 1 3 4 0 5