35
6 6 6 6 6 6 6 6 6 6
 2 4 2 2 3 2 2 4 2
2 2 4 2 4 4 2 4 2 2
 2 2 3 3 3 3 3 2 2
0 1 1 3 1 1 3 1 1 0
 5 2 2 3 1 3 2 2 5
5 5 2 2 3 3 2 2 5 5
 5 5 4 4 3 4 4 5 5
1 2 6 2 1 1 2 6 2 1
 1 2 6 2 1 2 6 2 1
1 1 5 5 2 2 5 5 1 1
 1 1 5 5 2 5 5 1 1