20
0 6 0 0 2 3 0 0 4 0
 6 6 0 2 0 3 0 4 4
0 6 6 2 2 3 3 4 4 0
 0 6 6 2 0 3 4 4 0
2 2 1 1 0 0 1 1 5 5
 0 6 6 5 0 2 4 4 0
0 6 6 5 5 2 2 4 4 0
 2 2 0 5 0 2 0 5 5
6 6 0 0 5 2 0 0 4 4
 6 0 0 0 3 0 0 0 4