30
3 3 4 4 1 1 6 6 2 2
 1 1 2 2 3 3 4 4 5
0 0 0 0 0 0 0 0 5 0
 2 2 4 4 3 3 1 1 0
0 1 3 3 5 5 2 2 0 0
 0 1 0 0 0 0 0 0 0
0 0 6 6 5 5 4 4 2 2
 0 0 3 3 2 2 6 6 1
0 0 0 0 0 0 0 0 1 0
 1 1 4 4 3 3 5 5 0
0 2 6 6 5 5 2 2 0 0
 0 2 0 0 0 0 0 0 0
0 0 6 6 1 1 4 4 3 3
 0 0 2 2 5 5 6 6 0