35
0 2 4 0 0 0 0 4 2 0
 2 2 4 6 6 6 4 2 2
0 2 2 4 6 6 4 2 2 0
 0 2 2 4 6 4 2 2 0
0 1 1 4 3 3 4 1 1 0
 2 2 4 3 6 3 4 2 2
2 2 5 6 1 1 6 5 2 2
 2 2 4 6 3 6 4 2 2
0 2 2 4 6 6 4 2 2 0
 0 5 5 4 1 4 5 5 0
0 2 2 4 1 1 4 2 2 0
 2 2 4 1 1 1 4 2 2
2 2 4 0 0 0 0 4 2 2