15
0 1 1 1 1 1 1 1 1 0
 1 6 6 6 6 6 6 6 1
0 6 2 2 2 2 2 2 6 0
 0 2 4 4 4 4 4 2 0
0 0 4 3 3 3 3 4 0 0
 0 0 3 5 5 5 3 0 0
0 0 0 5 1 1 5 0 0 0
 0 0 0 1 3 1 0 0 0
0 0 0 0 3 3 0 0 0 0
 0 0 0 4 3 4 0 0 0
0 0 0 2 4 4 2 0 0 0
 0 0 6 2 2 2 6 0 0
0 0 1 6 6 6 6 1 0 0
 0 3 1 1 1 1 1 3 0
0 5 3 3 3 3 3 3 5 0
 4 5 5 5 5 5 5 5 4
2 4 4 4 4 4 4 4 4 2
 2 2 2 2 2 2 2 2 2