20
5 5 0 0 2 2 0 0 5 5
 5 0 0 2 2 2 0 0 5
6 6 0 3 2 2 3 0 6 6
 6 6 3 3 5 3 3 6 6
1 1 4 3 5 5 3 4 1 1
 1 3 4 2 5 2 4 3 1
0 3 3 4 2 2 4 3 3 0
 3 3 3 4 2 4 3 3 3
3 3 3 3 4 4 3 3 3 3
 0 1 1 2 4 2 5 5 0
0 0 1 1 2 2 5 5 0 0
 0 0 1 1 2 5 5 0 0
0 0 0 1 1 5 5 0 0 0
 0 0 0 1 2 5 0 0 0
0 0 0 0 2 2 0 0 0 0