15
0 0 1 1 3 3 1 1 0 0
 0 1 3 3 4 3 3 1 0
0 2 2 2 4 4 2 2 2 0
 0 2 2 4 1 4 2 2 0
0 0 2 4 1 1 4 2 0 0
 0 5 4 1 3 1 4 5 0
0 5 5 3 3 3 3 5 5 0
 0 5 4 1 3 1 4 5 0
0 0 2 4 1 1 4 2 0 0
 0 2 2 4 1 4 2 2 0
0 2 2 2 4 4 2 2 2 0
 0 0 0 0 4 0 0 0 0