25
0 6 3 2 5 5 2 3 6 0
 6 3 2 5 2 5 2 3 6
6 3 2 5 4 4 5 2 3 6
 3 2 5 4 1 4 5 2 3
4 4 4 4 1 1 4 4 4 4
 4 1 1 1 1 1 1 1 4
6 4 1 1 1 1 1 1 4 6
 6 2 1 1 1 1 1 2 6
6 4 1 1 1 1 1 1 4 6
 4 1 1 1 1 1 1 1 4
4 4 4 4 1 1 4 4 4 4
 5 5 5 4 1 4 5 5 5
5 5 5 5 4 4 5 5 5 5
 5 5 5 5 2 5 5 5 5
4 4 1 1 2 2 6 6 3 3