40
1 6 3 3 1 2 6 3 6 1
 6 5 5 6 1 2 2 3 1
1 6 5 5 2 5 5 4 2 2
 3 2 5 5 1 1 4 3 3
4 3 2 6 6 1 2 5 5 4
 4 1 5 5 2 3 1 3 4
2 1 3 1 2 6 1 4 3 1
 2 3 1 1 6 3 3 4 1
5 6 2 3 5 2 4 6 6 3
 6 2 3 5 2 4 5 5 3
3 3 4 4 3 3 2 2 1 1
 4 5 5 2 2 1 1 4 4
4 3 3 1 1 0 5 5 2 2