40
4 4 4 1 6 5 4 5 6 4
 4 4 4 4 1 1 1 6 5
2 1 1 6 5 3 2 2 5 6
 2 4 4 6 5 3 1 6 6
3 6 6 2 3 1 2 2 2 2
 3 6 4 2 3 1 6 6 6
3 3 4 4 2 3 1 5 5 3
 3 3 1 1 4 4 2 2 3
5 5 4 4 2 2 1 1 4 4
 1 2 3 3 4 6 6 5 5
1 2 2 3 4 2 1 1 6 0
 4 1 1 4 6 2 1 6 0
0 0 0 4 0 0 2 6 0 0