20
5 5 5 5 5 5 5 5 5 5
 0 2 3 3 3 3 3 1 0
0 2 2 3 6 6 3 1 1 0
 2 2 2 5 6 5 1 1 1
2 2 2 2 5 5 1 1 1 1
 4 4 4 4 5 4 4 4 4
2 2 3 3 2 2 3 3 5 5
 2 3 3 4 6 4 3 3 5
0 3 3 5 6 6 5 3 3 0
 0 3 5 6 6 6 5 3 0
0 0 2 6 6 6 6 2 0 0
 0 0 2 2 0 2 2 0 0