20
6 6 1 1 3 3 4 4 5 5
 6 6 1 1 3 3 4 4 5
4 4 3 3 2 2 6 6 2 2
 4 2 3 4 2 5 6 3 2
1 2 2 4 4 5 5 3 3 1
 1 4 1 1 6 2 2 4 1
1 4 4 1 6 6 2 4 4 1
 0 0 4 4 5 5 4 4 0
0 0 0 0 1 1 0 0 0 0