30
5 5 3 3 3 3 3 3 5 5
 2 2 4 4 4 4 4 2 2
5 5 5 1 1 1 1 5 5 5
 3 6 3 2 2 2 3 6 3
0 3 3 0 5 5 0 3 3 0
 6 6 6 6 5 6 6 6 6
0 5 5 5 3 3 2 2 2 0
 4 5 5 4 3 4 2 2 4
0 4 5 4 0 0 4 2 4 0