50
0 4 4 2 2 1 1 4 4 0
 5 1 0 0 0 0 0 1 2
0 0 3 1 4 5 6 3 0 0
 4 5 0 0 0 0 0 2 6
0 0 6 3 5 1 4 5 0 0
 2 1 0 0 0 0 0 3 1
0 0 5 4 3 1 2 6 0 0
 3 2 0 0 0 0 0 3 2
0 0 6 4 3 6 4 5 0 0