20
3 1 0 0 0 0 0 0 1 3
 3 1 0 0 0 0 0 1 3
2 3 1 5 1 1 4 1 3 6
 2 3 5 5 0 4 4 3 6
0 2 2 6 6 1 1 6 6 0
 0 1 3 5 0 5 3 5 0
0 0 1 3 3 3 3 5 0 0
 0 0 1 1 4 5 5 0 0
0 0 0 6 4 4 3 0 0 0
 0 0 0 6 0 3 0 0 0
0 0 0 0 2 5 0 0 0 0