20
5 3 3 4 4 4 5 3 5 3
 5 5 5 6 6 3 5 5 3
0 3 3 3 1 1 3 3 3 0
 3 2 6 3 4 4 2 2 2
3 2 6 3 5 5 2 3 3 2
 2 6 3 1 1 1 2 2 2
6 6 3 0 4 4 2 3 3 2
 2 2 4 4 1 4 2 2 2
0 0 0 0 4 4 1 2 1 1