20
0 6 0 5 1 1 5 0 1 0
 6 6 5 0 1 0 5 1 1
0 6 4 3 2 2 4 3 1 0
 0 4 3 6 2 6 4 3 0
0 0 0 1 6 6 1 0 0 0
 0 2 2 3 4 3 2 2 0
0 0 2 0 4 4 0 2 0 0
 0 0 5 5 0 5 5 0 0
0 0 0 5 6 6 5 0 0 0
 0 0 0 6 6 6 0 0 0