30
4 3 4 3 4 3 4 3 4 3
 2 2 2 2 2 2 2 2 2
2 2 2 2 2 2 2 2 2 2
 4 5 3 2 4 2 3 5 4
4 3 0 5 2 2 5 0 3 4
 1 5 3 1 2 1 3 5 1
1 1 6 1 4 4 1 6 1 1
 1 6 1 1 4 1 1 6 1
1 6 1 1 3 3 1 1 6 1
 5 5 2 2 1 2 2 5 5