50
0 0 0 0 2 4 0 0 0 0
 0 0 0 4 1 2 0 0 0
0 0 0 2 5 6 4 0 0 0
 0 0 4 6 1 5 2 0 0
0 0 2 5 3 3 6 4 0 0
 0 4 6 1 0 1 5 2 0
0 2 5 0 3 3 0 6 4 0
 4 6 4 2 1 2 4 5 2