20
6 3 3 1 2 4 6 5 5 1
 6 1 3 2 0 4 5 6 1
6 3 3 1 2 4 6 5 5 1
 6 1 3 2 0 4 5 6 1
6 3 3 1 2 4 6 5 5 1
 6 1 3 2 0 4 5 6 1
6 3 3 1 2 4 6 5 5 1
 6 1 3 2 0 4 5 6 1
6 3 3 1 2 4 6 5 5 1
 1 1 4 4 0 2 2 6 6